obs,raw_obs,action,reward,episode,agent_idx
[1. 0. 0. 0. 0. 0. 0. 0. 1. 0. 0. 0. 0. 0. 0. 0. 1. 0. 0. 0. 0. 0.],"[ 1.  0.  0.  0.  0.  0.  0.  0. -4. -2.  0. -2.  2.  2.  0.  0.  0.  0.
 -3.  3.  0.  0.  1.  1.  0.  0.  0.  0.  0.  0. -1. -2.  1.  1.  0.  0.
  0.  0.  0.  0. -5. -2.  0.  1.  0.  0.  1.  0.  0.  0.  0.  0.  0.  0.
  2. -2.  6. -2. -1.  2.  0.  0.  0.  0.  3.  3.  0.  0.  1.  1.  0.  0.
  0.  0.  0.  0.  1. -2.  1.  1.  0.  0.  0.  0.  0.  0.  5. -2.  0.  0.
  0.  1. -6.  0.  7.  2.]",3,0,0,0
[0. 0. 0. 1. 0. 0. 0. 0. 1. 0. 0. 0. 0. 0. 0. 0. 1. 0. 0. 0. 0. 0.],"[ 0.  0.  0.  1.  0.  0.  0.  0. -3. -2.  1. -2.  3.  2.  0.  0.  0.  0.
 -2.  3.  0.  0.  1.  1.  0.  0.  0.  0.  0.  0.  0. -2.  1.  1.  0.  0.
  0.  0.  0.  0. -4. -2.  0.  1.  0.  0.  1.  0.  0.  0.  0.  0.  0.  0.
  2. -2.  6. -2. -1.  2.  0.  0.  0.  0.  3.  3.  0.  0.  1.  1.  0.  0.
  0.  0.  0.  0.  1. -2.  1.  1.  0.  0.  0.  0.  0.  0.  5. -2.  0.  0.
  0.  1. -5.  0.  6.  2.]",3,0,0,0
[0. 0. 0. 1. 0. 0. 0. 0. 1. 0. 0. 0. 0. 0. 0. 0. 1. 0. 0. 0. 0. 0.],"[ 0.  0.  0.  1.  0.  0.  0.  0. -2. -2.  2. -2.  4.  2.  0.  0.  0.  0.
 -1.  3.  0.  0.  1.  1.  0.  0.  0.  0.  0.  0.  1. -2.  1.  1.  0.  0.
  0.  0.  0.  0. -3. -2.  0.  1.  0.  1.  1.  0.  0.  0.  0.  0.  0.  0.
  2. -2.  6. -2. -1.  2.  0.  0.  0.  0.  3.  3.  0.  0.  1.  1.  0.  0.
  0.  0.  0.  0.  1. -2.  1.  1.  0.  0.  0.  0.  0.  0.  5. -2.  0.  0.
  0.  1. -4.  0.  5.  2.]",0,0,0,0
[1. 0. 0. 0. 0. 0. 0. 0. 1. 0. 0. 0. 0. 0. 0. 0. 1. 0. 0. 0. 0. 0.],"[ 1.  0.  0.  0.  0.  0.  0.  0. -2. -1.  2. -1.  4.  3.  0.  0.  0.  0.
 -1.  4.  0.  0.  1.  1.  0.  0.  0.  0.  0.  0.  1. -1.  1.  1.  0.  0.
  0.  0.  0.  0. -3. -1.  1.  0.  0.  1.  1.  0.  0.  0.  0.  0.  0.  0.
  2. -2.  6. -2. -1.  2.  0.  0.  0.  0.  3.  3.  0.  0.  1.  1.  0.  0.
  0.  0.  0.  0.  1. -2.  1.  1.  0.  0.  0.  0.  0.  0.  5. -2.  0.  0.
  0.  1. -4.  1.  5.  1.]",2,0,0,0
[0. 0. 1. 0. 0. 0. 0. 0. 1. 0. 0. 0. 0. 0. 0. 0. 1. 0. 0. 0. 0. 0.],"[ 0.  0.  1.  0.  0.  0.  0.  0. -3. -1.  1. -1.  3.  3.  0.  0.  0.  0.
 -2.  4.  0.  0.  1.  1.  0.  0.  0.  0.  0.  0.  0. -1.  1.  1.  0.  0.
  0.  0.  0.  0. -4. -1.  1.  0.  0.  0.  1.  0.  0.  0.  0.  0.  0.  0.
  2. -2.  6. -2. -1.  2.  0.  0.  0.  0.  3.  3.  0.  0.  1.  1.  0.  0.
  0.  0.  0.  0.  1. -2.  1.  1.  0.  0.  0.  0.  0.  0.  5. -2.  0.  0.
  0.  1. -5.  1.  6.  1.]",2,0,0,0
[0. 0. 1. 0. 0. 0. 0. 0. 1. 0. 0. 0. 0. 0. 0. 0. 1. 0. 0. 0. 0. 0.],"[ 0.  0.  1.  0.  0.  0.  0.  0. -4. -1.  0. -1.  2.  3.  0.  0.  0.  0.
 -3.  4.  0.  0.  1.  1.  0.  0.  0.  0.  0.  0. -1. -1.  1.  1.  0.  0.
  0.  0.  0.  0. -5. -1.  1.  0.  0.  0.  1.  0.  0.  0.  0.  0.  0.  0.
  2. -2.  6. -2. -1.  2.  0.  0.  0.  0.  3.  3.  0.  0.  1.  1.  0.  0.
  0.  0.  0.  0.  1. -2.  1.  1.  0.  0.  0.  0.  0.  0.  5. -2.  0.  0.
  0.  1. -6.  1.  7.  1.]",0,0,0,0
